{
  "name": "Security Grid",
  "width": 35,
  "height": 15,
  "theme": 2,
  "map": [
    "###################################",
    "#                                 #",
    "#               *                 #",
    "#             #####               #",
    "#            #######              #",
    "#      **                         #",
    "#     ____                        #",
    "#  P                   B       E  #",
    "# ###                 ###     ### #",
    "#         ##                      #",
    "#        ####        *            #",
    "#                   ###           #",
    "#    ^^^^^^^^^^^                  #",
    "#    ###########                  #",
    "###################################"
  ],
  "movingPlatforms": [
    { "x": 10, "y": 7, "width": 2.5, "height": 0.8, "rangeX": 0, "rangeY": -3, "speed": 80 },
    { "x": 22, "y": 10, "width": 2.5, "height": 0.8, "rangeX": 4, "rangeY": 0, "speed": 70 }
  ],
  "patrols": [
    { "x": 9.5, "y": 2.2, "rangeX": 140, "speed": 50 }
  ]
}
