{
  "name": "Mainframe Entrance",
  "width": 25,
  "height": 15,
  "theme": 1,
  "map": [
    "#########################",
    "#                       #",
    "#                       #",
    "#         ***           #",
    "#        _____          #",
    "#                       #",
    "#   P                   #",
    "#  ###             E    #",
    "#        ##       ###   #",
    "#       ####            #",
    "#                       #",
    "#      *    *    *      #",
    "#    #####^^^^#####     #",
    "#                       #",
    "#########################"
  ],
  "movingPlatforms": [
    { "x": 11, "y": 7, "width": 3, "height": 0.8, "rangeX": 4, "rangeY": 0, "speed": 60 }
  ],
  "patrols": []
}
