{
  "name": "Quantum Nexus",
  "width": 45,
  "height": 18,
  "theme": 6,
  "map": [
    "#############################################",
    "#          *  *  *           !         *   #",
    "#         _____        L     !    *        #",
    "# P                         !   ###       #",
    "# ##      ##            #####         E   #",
    "#              M        #   1        ###   #",
    "#   W         ###       #  ###             #",
    "# #####   T             #         @@@@@@@@@#",
    "#         #    ZZZZZ    #                  #",
    "#  *      #    ZZZZZ    #   *   2     *    #",
    "# ###     #    ZZZZZ    #  ##  ###   ###   #",
    "#         #             #   ^              #",
    "#    B    ####   ####   #  ###   T         #",
    "#   ###         W    $$$#                  #",
    "#   ^^^   *            $#      3    M      #",
    "#        ###    L      $#     ###          #",
    "#  M          #####     #          #####   #",
    "#############################################"
  ],
  "movingPlatforms": [
    { "x": 20, "y": 5, "width": 2, "height": 0.8, "rangeX": 0, "rangeY": -3, "speed": 80 }
  ],
  "patrols": []
}
