{
  "name": "The Mainframe Core",
  "width": 25,
  "height": 15,
  "theme": 5,
  "map": [
    "#########################",
    "#                       #",
    "#                       #",
    "#                       #",
    "#                       #",
    "#                       #",
    "#                       #",
    "#                       #",
    "#                       #",
    "#  P                    #",
    "# ###                 ###",
    "#                       #",
    "#    B             B    #",
    "#########################",
    "#########################"
  ],
  "movingPlatforms": [],
  "patrols": [],
  "isBossLevel": true
}
