{
  "name": "The Inner Core",
  "width": 45,
  "height": 16,
  "theme": 4,
  "map": [
    "#############################################",
    "#      ###                                  #",
    "#      #GS                         *        #",
    "#      ####                       ##        #",
    "#                                           #",
    "#             ###     ###                   #",
    "#             vvv     vvv                   #",
    "#    H                   H             E    #",
    "#   ____                ____          ###   #",
    "#                                           #",
    "#  P         *     *     *     *            #",
    "# ###      III   III   III   III            #",
    "#                                           #",
    "#     B  ##^^##  B  ##^^##  B  ##^^##       #",
    "#    ##################################     #",
    "#############################################"
  ],
  "movingPlatforms": [
    { "x": 10, "y": 4, "width": 2.5, "height": 0.8, "rangeX": 4, "rangeY": 0, "speed": 85 },
    { "x": 32, "y": 6, "width": 2.5, "height": 0.8, "rangeX": 0, "rangeY": -3, "speed": 110 }
  ],
  "patrols": [
    { "x": 4, "y": 7.5, "rangeX": 100, "speed": 70 },
    { "x": 20, "y": 7.5, "rangeX": 140, "speed": 100 },
    { "x": 24, "y": 2.5, "rangeX": 100, "speed": 120 }
  ]
}
